############################################################
#               #####                                   ####
## ##### ###### ###### ##    ###### ###### ##### ###### ####
##              ######              ######              ####
### ########            ################### ################
###  #############  ###  #########       ## ################
#               ##                  ###                 ####
## ##### ###### #####  ##### ###### ###### ##### ###### ####
##                                  ######    #         ####
##### #### ############## ##    ################## #########
##### #### ############## ####  ############# #### #########
#               #####                              #    ####
## ##### ###### ###### ##### ###### ###### ##### ###### ####
##              ######                                  ####
############################################################
1,1